NO ./block_textures/bluestone.xpm
SO ./block_textures/redbrick.xpm
WE ./block_textures/wood.xpm
EA ./block_textures/greystone.xpm
DO ./bonus_textures/door.xpm
S1 ./bonus_textures/mushroom1.xpm
S2 ./bonus_textures/mushroom2.xpm
S3 ./bonus_textures/mushroom3.xpm
S4 ./bonus_textures/mushroom4.xpm

F 102,102,255
C 153,255,255

        1111111111111111111111111
        1000000000110000000000001
        1011000001110000000000001
        1001000000000000000000001
111111111011000001110000000000001
100000001211000001110111111111111
10000000000000011100000010001
10000000000000011101010010001
10000000000000311100000010001
10000000000000001100000010001
10000000000N00001101010010001
1100000111010101111101111000111
11110111 1110101 101111010001
11111111 1111111 111111111111